mai châu|m châu	hòa bình|h bình|hbình
quận 5|5|q5	 hồ chí minh|hcm|hồchíminh|tp hồ chí minh|tp hồchíminh|tp hồ cm|hồ cm
cầu kè|c kè	trà vinh|t vinh|tvinh
ứng hòa|ứ hòa|ứh	hà nội|hn|h nội|hnội
hòa an|h an	cao bằng|c bằng|cbằng
bắc ninh|b ninh|bninh	bắc ninh|b ninh|bninh
thống nhất|t nhất	đồng nai|đ nai|đnai
lai châu|l châu|lchâu	lai châu|l châu|lchâu
quận 8|8|q8	 hồ chí minh|hcm|hồchíminh|tp hồ chí minh|tp hồchíminh|tp hồ cm|hồ cm
lang chánh|l chánh	thanh hóa|t hóa|thóa
đống đa|đ đa|đđ	hà nội|hn|h nội|hnội
thới lai|t lai	cần thơ|c thơ|cthơ
châu thành a|c thành a	cần thơ|c thơ|cthơ
bố trạch	quảng bình|q bình|qbình
đắk tô|đ tô	kon tum|k tum|ktum
hai bà trưng|h b trưng|hbt	hà nội|hn|h nội|hnội
trạm tấu|t tấu	yên bái|y bái|ybái
dĩ an	bình dương|b dương
phú quốc|p quốc	kiên giang|k giang
phước sơn|p sơn	quảng nam|q nam
đức linh|đ linh	bình thuận|b thuận
hải lăng|h lăng	quảng trị|q trị
buôn hồ|b hồ	đắk lắk|đ lắk|đlắk|đăk lăk|đ lăk|đlăk
thái bình|t bình	thái bình|t bình
ninh bình|n bình	ninh bình|n bình
đăk pơ|đ pơ	gia lai|g lai
quận 3|3|q3	 hồ chí minh|hcm|hồchíminh|tp hồ chí minh|tp hồchíminh|tp hồ cm|hồ cm
phúc thọ|p thọ|pt	hà nội|hn|h nội|hnội
krông pa|k pa	gia lai|g lai
bá thước	thanh hóa|t hóa|thóa
đông hòa|đ hòa	phú yên|p yên
an phú	an giang
tuyên hóa|t hóa	quảng bình|q bình|qbình
phú bình|p bình	thái nguyên|t nguyên
xuân trường|x trường	nam định|n định
bà rịa	 bà rịa vũng tàu|bà rịa|vũng tàu|b rịa v tàu|bà rịa vtàu|brịa vtàu
bắc sơn|b sơn	lạng sơn|l sơn
tuy hòa|t hòa	phú yên|p yên
đông giang|đ giang	quảng nam|q nam
long biên|l biên|lb	hà nội|hn|h nội|hnội
yên mỹ|y mỹ	hưng yên|h yên
thanh xuân|t xuân|tx	hà nội|hn|h nội|hnội
hải châu|h châu|hc	đà nẵng|đn|t phố đà nẵng| tp đà nẵng|đànẵng
mường tè|m tè	lai châu|l châu|lchâu
cái răng|c răng	cần thơ|c thơ|cthơ
hoàng su phì|h s phì	hà giang|h giang
đồng văn|đ văn	hà giang|h giang
đồng xuân|đ xuân	phú yên|p yên
hòa bình|h bình|hbình	hòa bình|h bình|hbình
thuận châu|t châu	sơn la
cao lộc|c lộc	lạng sơn|l sơn
yên thành|y thành	nghệ an
tân thành|t thành	 bà rịa vũng tàu|bà rịa|vũng tàu|b rịa v tàu|bà rịa vtàu|brịa vtàu
mai sơn|m sơn	sơn la
can lộc|c lộc	hà tĩnh|h tĩnh
yên bái|y bái|ybái	yên bái|y bái|ybái
sìn hồ|s hồ	lai châu|l châu|lchâu
mỹ xuyên	sóc trăng|s trăng
yên bình|y bình	yên bái|y bái|ybái
đà lạt	lâm đồng|l đồng
gò công tây|g c tây	tiền giang|t giang
bình thủy|b thủy	cần thơ|c thơ|cthơ
sông hinh|s hinh	phú yên|p yên
krông bông|k bông	đắk lắk|đ lắk|đlắk|đăk lăk|đ lăk|đlăk
phổ yên|p yên	thái nguyên|t nguyên
an lão|al	hải phòng|hp
gò quao	kiên giang|k giang
krông a na|k a na	đắk lắk|đ lắk|đlắk|đăk lăk|đ lăk|đlăk
thanh oai|t oai|to	hà nội|hn|h nội|hnội
trà lĩnh|t lĩnh	cao bằng|c bằng|cbằng
mường ảng|m ảng	điện biên|đ biên
thanh sơn|t sơn	phú thọ|p thọ
cái nước|c nước	cà mau|c mau
đô lương	nghệ an
hưng hà|h hà	thái bình|t bình
tân trụ|t trụ	long an|l an
hòa bình|h bình|hbình	bạc liêu|b liêu
cẩm thủy|c thủy	thanh hóa|t hóa|thóa
tánh linh|t linh	bình thuận|b thuận
nam trực|n trực	nam định|n định
phú thiện|p thiện	gia lai|g lai
mường nhé|m nhé	điện biên|đ biên
gò dầu	tây ninh|t ninh
trực ninh|t ninh	nam định|n định
phước long|p long	bạc liêu|b liêu
châu thành|c thành	bến tre|b tre
bình minh|b minh	vĩnh long|v long|vĩnhlong
nam sách|n sách	hải dương|h dương
long khánh|l khánh	đồng nai|đ nai|đnai
hiệp đức|h đức	quảng nam|q nam
tây sơn|t sơn	bình định|b định
bình giang|b giang	hải dương|h dương
hồng ngự|h ngự	đồng tháp|đ tháp
thái hòa|t hòa	nghệ an
thủy nguyên|t nguyên|tn	hải phòng|hp
hải dương|h dương	hải dương|h dương
con cuông|c cuông	nghệ an
quận 11|11|q11	 hồ chí minh|hcm|hồchíminh|tp hồ chí minh|tp hồchíminh|tp hồ cm|hồ cm
đồng xoài|đ xoài	bình phước|b phước
cai lậy|c lậy	tiền giang|t giang
đắk song|đ song	đắk nông|đ nông
lâm thao|l thao	phú thọ|p thọ
hạ lang	cao bằng|c bằng|cbằng
long phú|l phú	sóc trăng|s trăng
thạnh phú|t phú	bến tre|b tre
giao thủy|g thủy	nam định|n định
u minh	cà mau|c mau
bắc tân uyên|b t uyên	bình dương|b dương
gia viễn|g viễn	ninh bình|n bình
chư păh|c păh	gia lai|g lai
gò công	tiền giang|t giang
trà ôn|t ôn	vĩnh long|v long|vĩnhlong
long mỹ|l mỹ	hậu giang|h giang
vũng tàu|v tàu|vtàu	 bà rịa vũng tàu|bà rịa|vũng tàu|b rịa v tàu|bà rịa vtàu|brịa vtàu
đồng phú|đ phú	bình phước|b phước
thái thụy|t thụy	thái bình|t bình
cư m'gar	đắk lắk|đ lắk|đlắk|đăk lăk|đ lăk|đlăk
ninh hải|n hải	ninh thuận|n thuận
tân sơn|t sơn	phú thọ|p thọ
tân hồng|t hồng	đồng tháp|đ tháp
tu mơ rông|t m rông	kon tum|k tum|ktum
lộc ninh|l ninh	bình phước|b phước
nghĩa đàn|n đàn	nghệ an
bảo lâm|b lâm	cao bằng|c bằng|cbằng
phú lương|p lương	thái nguyên|t nguyên
trà cú|t cú	trà vinh|t vinh|tvinh
lai vung|l vung	đồng tháp|đ tháp
đại lộc|đ lộc	quảng nam|q nam
tiên phước|t phước	quảng nam|q nam
từ liêm|nam từ liêm|tl|ntl	hà nội|hn|h nội|hnội
đa krông	quảng trị|q trị
châu thành|c thành	hậu giang|h giang
sốp cộp|s cộp	sơn la
hải an|h an|ha	hải phòng|hp
yên mô|y mô	ninh bình|n bình
lạc sơn|l sơn	hòa bình|h bình|hbình
m'đrắk	đắk lắk|đ lắk|đlắk|đăk lăk|đ lăk|đlăk
điện biên phủ|đ b phủ	điện biên|đ biên
cái bè|c bè	tiền giang|t giang
ayun pa|a pa	gia lai|g lai
thanh miện|t miện	hải dương|h dương
tĩnh gia|t gia	thanh hóa|t hóa|thóa
cù lao dung|c l dung	sóc trăng|s trăng
nha trang|n trang	khánh hòa|k hòa
hoành bồ|h bồ	quảng ninh|q ninh
sông công|s công	thái nguyên|t nguyên
đắk hà|đ hà	kon tum|k tum|ktum
cát hải|c hải|ch	hải phòng|hp
hải hậu|h hậu	nam định|n định
thiệu hóa|t hóa	thanh hóa|t hóa|thóa
như xuân|n xuân	thanh hóa|t hóa|thóa
krông nô|k nô	đắk nông|đ nông
đà bắc	hòa bình|h bình|hbình
quỳnh nhai|q nhai	sơn la
bạc liêu|b liêu	bạc liêu|b liêu
mang thít|m thít	vĩnh long|v long|vĩnhlong
tuyên quang|t quang	tuyên quang|t quang
uông bí|u bí	quảng ninh|q ninh
quốc oai|q oai|qo	hà nội|hn|h nội|hnội
nam giang|n giang	quảng nam|q nam
điện biên|đ biên	điện biên|đ biên
mộc châu|m châu	sơn la
bắc mê|b mê	hà giang|h giang
ngân sơn|n sơn	bắc kạn|b kạn
thạnh hóa|t hóa	long an|l an
tiên lãng|t lãng|tl	hải phòng|hp
quảng yên|q yên	quảng ninh|q ninh
minh long|m long	quảng ngãi|q ngãi
phụng hiệp|p hiệp	hậu giang|h giang
móng cái|m cái	quảng ninh|q ninh
phú thọ|p thọ	phú thọ|p thọ
bình xuyên|b xuyên	vĩnh phúc|v phúc
ninh giang|n giang	hải dương|h dương
hàm tân|h tân	bình thuận|b thuận
la gi	bình thuận|b thuận
sông mã|s mã	sơn la
tư nghĩa	quảng ngãi|q ngãi
châu thành|c thành	trà vinh|t vinh|tvinh
quế võ|q võ	bắc ninh|b ninh|bninh
cam lâm|c lâm	khánh hòa|k hòa
nhà bè|n bè|nb	 hồ chí minh|hcm|hồchíminh|tp hồ chí minh|tp hồchíminh|tp hồ cm|hồ cm
thạch thất|t thất|tt	hà nội|hn|h nội|hnội
quận 1|1|q1	 hồ chí minh|hcm|hồchíminh|tp hồ chí minh|tp hồchíminh|tp hồ cm|hồ cm
tiên du|t du	bắc ninh|b ninh|bninh
hoài nhơn|h nhơn	bình định|b định
ia pa	gia lai|g lai
đắk r'lấp	đắk nông|đ nông
vĩnh long|v long|vĩnhlong	vĩnh long|v long|vĩnhlong
tuy an|t an	phú yên|p yên
lê chân|lc	hải phòng|hp
cư kuin	đắk lắk|đ lắk|đlắk|đăk lăk|đ lăk|đlăk
đồng hỷ|đ hỷ	thái nguyên|t nguyên
mỹ hào	hưng yên|h yên
mường khương|m khương	lào cai|l cai
xín mần|x mần	hà giang|h giang
gia nghĩa|g nghĩa	đắk nông|đ nông
ba tơ	quảng ngãi|q ngãi
đạ huoai	lâm đồng|l đồng
phú nhuận|p nhuận|pn	 hồ chí minh|hcm|hồchíminh|tp hồ chí minh|tp hồchíminh|tp hồ cm|hồ cm
ô môn	cần thơ|c thơ|cthơ
pác nặm|p nặm	bắc kạn|b kạn
đông hải|đ hải	bạc liêu|b liêu
lục ngạn|l ngạn	bắc giang|b giang
lập thạch|l thạch	vĩnh phúc|v phúc
rạch giá|r giá	kiên giang|k giang
lâm hà|l hà	lâm đồng|l đồng
cầu ngang|c ngang	trà vinh|t vinh|tvinh
nghi lộc|n lộc	nghệ an
hàm thuận bắc|h t bắc	bình thuận|b thuận
hưng nguyên|h nguyên	nghệ an
đông hà|đ hà	quảng trị|q trị
quy nhơn|q nhơn	bình định|b định
thanh chương|t chương	nghệ an
nam trà my|n t my	quảng nam|q nam
kiến xương|k xương	thái bình|t bình
sông lô|s lô	vĩnh phúc|v phúc
hoàn kiếm|h kiếm|hk	hà nội|hn|h nội|hnội
đức thọ|đ thọ	hà tĩnh|h tĩnh
triệu phong|t phong	quảng trị|q trị
kỳ sơn	hòa bình|h bình|hbình
lộc bình|l bình	lạng sơn|l sơn
long hồ|l hồ	vĩnh long|v long|vĩnhlong
tân phú|t phú|tp	 hồ chí minh|hcm|hồchíminh|tp hồ chí minh|tp hồchíminh|tp hồ cm|hồ cm
lâm bình|l bình	tuyên quang|t quang
sa thầy	kon tum|k tum|ktum
chư prông|c prông	gia lai|g lai
tam đường|t đường	lai châu|l châu|lchâu
mường lay|m lay	điện biên|đ biên
hòn đất|h đất	kiên giang|k giang
chợ mới|c mới	bắc kạn|b kạn
việt yên|v yên	bắc giang|b giang
sơn hà|s hà	quảng ngãi|q ngãi
thủ dầu một|t d một	bình dương|b dương
thanh hà|t hà	hải dương|h dương
vụ bản	nam định|n định
chợ lách|c lách	bến tre|b tre
bình đại|b đại	bến tre|b tre
gia lộc|g lộc	hải dương|h dương
quảng xương|q xương	thanh hóa|t hóa|thóa
vũng liêm|v liêm	vĩnh long|v long|vĩnhlong
nguyên bình|n bình	cao bằng|c bằng|cbằng
phù mỹ|p mỹ	bình định|b định
tân an|t an	long an|l an
thanh hóa|t hóa|thóa	thanh hóa|t hóa|thóa
khánh vĩnh|k vĩnh	khánh hòa|k hòa
định quán|đ quán	đồng nai|đ nai|đnai
tân uyên|t uyên	lai châu|l châu|lchâu
bù đăng	bình phước|b phước
phú ninh|p ninh	quảng nam|q nam
hà tiên	kiên giang|k giang
thuận thành|t thành	bắc ninh|b ninh|bninh
tịnh biên|t biên	an giang
hữu lũng|h lũng	lạng sơn|l sơn
châu thành|c thành	long an|l an
quận 2|2|q2	 hồ chí minh|hcm|hồchíminh|tp hồ chí minh|tp hồchíminh|tp hồ cm|hồ cm
na hang	tuyên quang|t quang
châu thành|c thành	tiền giang|t giang
tây hồ|t hồ|th	hà nội|hn|h nội|hnội
thạch an|t an	cao bằng|c bằng|cbằng
thuận bắc|t bắc	ninh thuận|n thuận
tháp mười|t mười	đồng tháp|đ tháp
chợ đồn|c đồn	bắc kạn|b kạn
anh sơn|a sơn	nghệ an
trảng bom|t bom	đồng nai|đ nai|đnai
châu thành|c thành	đồng tháp|đ tháp
cao lãnh|c lãnh	đồng tháp|đ tháp
hòa thành|h thành	tây ninh|t ninh
chiêm hóa|c hóa	tuyên quang|t quang
cao phong|c phong	hòa bình|h bình|hbình
đức hòa|đ hòa	long an|l an
dương kinh|d kinh|dk	hải phòng|hp
an hải|a hải|ah	hải phòng|hp
thủ thừa|t thừa	long an|l an
sông cầu|s cầu	phú yên|p yên
hạ long	quảng ninh|q ninh
long điền|longđiền|l điền	 bà rịa vũng tàu|bà rịa|vũng tàu|b rịa v tàu|bà rịa vtàu|brịa vtàu
duy tiên|d tiên	hà nam|h nam
thanh khê|t khê|tk	đà nẵng|đn|t phố đà nẵng| tp đà nẵng
quỳnh lưu|q lưu	nghệ an
tam nông|t nông	phú thọ|p thọ
lương tài|l tài	bắc ninh|b ninh|bninh
kỳ sơn	nghệ an
ninh sơn|n sơn	ninh thuận|n thuận
chư pưh|c pưh	gia lai|g lai
bắc kạn|b kạn	bắc kạn|b kạn
ba chẽ	quảng ninh|q ninh
bát xát|b xát	lào cai|l cai
thường xuân|t xuân	thanh hóa|t hóa|thóa
diên khánh|d khánh	khánh hòa|k hòa
thới bình|t bình	cà mau|c mau
năm căn|n căn	cà mau|c mau
sơn hòa|s hòa	phú yên|p yên
võ nhai	thái nguyên|t nguyên
bảo thắng|b thắng	lào cai|l cai
mèo vạc|m vạc	hà giang|h giang
vân canh|v canh	bình định|b định
đơn dương|đ dương	lâm đồng|l đồng
tuy phước|t phước	bình định|b định
tứ kỳ	hải dương|h dương
ninh phước|n phước	ninh thuận|n thuận
đông sơn|đ sơn	thanh hóa|t hóa|thóa
phan rang-tháp chàm|p rang-t chàm|phan rang-t chàm	ninh thuận|n thuận
bến lức|b lức	long an|l an
vĩnh hưng|v hưng	long an|l an
hà trung	thanh hóa|t hóa|thóa
tân phước|t phước	tiền giang|t giang
di linh	lâm đồng|l đồng
sa pa	lào cai|l cai
bắc quang|b quang	hà giang|h giang
tuy phong|t phong	bình thuận|b thuận
tân kỳ|t kỳ	nghệ an
đức trọng|đ trọng	lâm đồng|l đồng
bình thạnh|b thạnh|bt	 hồ chí minh|hcm|hồchíminh|tp hồ chí minh|tp hồchíminh|tp hồ cm|hồ cm
quận 9|9|q9	 hồ chí minh|hcm|hồchíminh|tp hồ chí minh|tp hồchíminh|tp hồ cm|hồ cm
định hóa|đ hóa	thái nguyên|t nguyên
cần giờ|c giờ|cg	 hồ chí minh|hcm|hồchíminh|tp hồ chí minh|tp hồchíminh|tp hồ cm|hồ cm
giang thành|g thành	kiên giang|k giang
hoàng mai|h mai|hm	hà nội|hn|h nội|hnội
yên sơn|y sơn	tuyên quang|t quang
bảo yên|b yên	lào cai|l cai
mường chà|m chà	điện biên|đ biên
thăng bình|t bình	quảng nam|q nam
đắk mil|đ mil	đắk nông|đ nông
mỏ cày nam|m c nam	bến tre|b tre
hớn quản|h quản	bình phước|b phước
bảo lâm|b lâm	lâm đồng|l đồng
quảng ngãi|q ngãi	quảng ngãi|q ngãi
đình lập|đ lập	lạng sơn|l sơn
vị thanh	hậu giang|h giang
bình gia|b gia	lạng sơn|l sơn
vân đồn|v đồn	quảng ninh|q ninh
thanh ba|t ba	phú thọ|p thọ
phú xuyên|p xuyên|px	hà nội|hn|h nội|hnội
phú hòa|p hòa	phú yên|p yên
phước long|p long	bình phước|b phước
kế sách	sóc trăng|s trăng
mê linh|ml	hà nội|hn|h nội|hnội
chư sê|c sê	gia lai|g lai
tây hòa|t hòa	phú yên|p yên
thoại sơn|t sơn	an giang
bỉm sơn|b sơn	thanh hóa|t hóa|thóa
đông hưng|đ hưng	thái bình|t bình
đông anh|đ anh|đa	hà nội|hn|h nội|hnội
việt trì|v trì	phú thọ|p thọ
mộc hóa|m hóa	long an|l an
trùng khánh|t khánh	cao bằng|c bằng|cbằng
duy xuyên|d xuyên	quảng nam|q nam
cư jút	đắk nông|đ nông
mỹ tho	tiền giang|t giang
kiến tường|k tường	long an|l an
phục hòa|p hòa	cao bằng|c bằng|cbằng
tiên lữ|t lữ	hưng yên|h yên
bù đốp	bình phước|b phước
vĩnh cửu|v cửu	đồng nai|đ nai|đnai
yên lập|y lập	phú thọ|p thọ
mỹ lộc	nam định|n định
ninh kiều|n kiều	cần thơ|c thơ|cthơ
bình chánh|b chánh|bc	 hồ chí minh|hcm|hồchíminh|tp hồ chí minh|tp hồchíminh|tp hồ cm|hồ cm
lục yên|l yên	yên bái|y bái|ybái
tân bình|t bình|tb	 hồ chí minh|hcm|hồchíminh|tp hồ chí minh|tp hồchíminh|tp hồ cm|hồ cm
kông chro|k chro	gia lai|g lai
cần giuộc|c giuộc	long an|l an
trần văn thời|t v thời	cà mau|c mau
xuyên mộc|x mộc	 bà rịa vũng tàu|bà rịa|vũng tàu|b rịa v tàu|bà rịa vtàu|brịa vtàu
ba đình|bđ	hà nội|hn|h nội|hnội
u minh thượng|u m thượng	kiên giang|k giang
châu thành|c thành	an giang
bình tân|b tân|bt	 hồ chí minh|hcm|hồchíminh|tp hồ chí minh|tp hồchíminh|tp hồ cm|hồ cm
tam điệp|t điệp	ninh bình|n bình
tam đảo|t đảo	vĩnh phúc|v phúc
si ma cai|s m cai	lào cai|l cai
mộ đức	quảng ngãi|q ngãi
phong điền|p điền	cần thơ|c thơ|cthơ
châu đức|c đức	 bà rịa vũng tàu|bà rịa|vũng tàu|b rịa v tàu|bà rịa vtàu|brịa vtàu
tủa chùa|t chùa	điện biên|đ biên
yên phong|y phong	bắc ninh|b ninh|bninh
quảng điền|q điền	thừa thiên huế|tt huế|tth
châu đốc|c đốc	an giang
hà đông|hđ	hà nội|hn|h nội|hnội
ngọc lặc|n lặc	thanh hóa|t hóa|thóa
vị thủy	hậu giang|h giang
kim bảng|k bảng	hà nam|h nam
hương khê|h khê	hà tĩnh|h tĩnh
tân biên|t biên	tây ninh|t ninh
ninh hòa|n hòa	khánh hòa|k hòa
vũ thư	thái bình|t bình
nậm pồ|n pồ	điện biên|đ biên
đắk glei|đ glei	kon tum|k tum|ktum
trảng bàng|t bàng	tây ninh|t ninh
thạch hà|t hà	hà tĩnh|h tĩnh
bù gia mập|b g mập	bình phước|b phước
cẩm mỹ|c mỹ	đồng nai|đ nai|đnai
cần đước|c đước	long an|l an
quận 10|10|q10	 hồ chí minh|hcm|hồchíminh|tp hồ chí minh|tp hồchíminh|tp hồ cm|hồ cm
ý yên	nam định|n định
kiến an|k an|ka	hải phòng|hp
vĩnh thạnh|v thạnh	bình định|b định
tân phú|t phú	đồng nai|đ nai|đnai
phú riềng|p riềng	bình phước|b phước
kbang	gia lai|g lai
bình sơn|b sơn	quảng ngãi|q ngãi
krông pắc|k pắc	đắk lắk|đ lắk|đlắk|đăk lăk|đ lăk|đlăk
than uyên|t uyên	lai châu|l châu|lchâu
ba bể	bắc kạn|b kạn
yên lạc|y lạc	vĩnh phúc|v phúc
quỳnh phụ|q phụ	thái bình|t bình
a lưới	thừa thiên huế|tt huế|tth
sơn la|s la	sơn la
phù cừ|p cừ	hưng yên|h yên
nam đông|n đông	thừa thiên huế|tt huế|tth
hà giang	hà giang|h giang
văn yên|v yên	yên bái|y bái|ybái
đăk glong|đ glong	đắk nông|đ nông
thạch thành|t thành	thanh hóa|t hóa|thóa
ia grai	gia lai|g lai
hải hà|h hà	quảng ninh|q ninh
mỹ tú	sóc trăng|s trăng
tân châu|t châu	tây ninh|t ninh
phủ lý|p lý	hà nam|h nam
hòa vang|h vang|hv	đà nẵng|đn|t phố đà nẵng| tp đà nẵng
châu thành a|c t a	hậu giang|h giang
nông cống|n cống	thanh hóa|t hóa|thóa
thanh bình|t bình	đồng tháp|đ tháp
sơn động|s động	bắc giang|b giang
pleiku	gia lai|g lai
chi lăng|c lăng	lạng sơn|l sơn
nga sơn|n sơn	thanh hóa|t hóa|thóa
kon plông|k plông	kon tum|k tum|ktum
hoa lư|h lư	ninh bình|n bình
dương minh châu|d m châu	tây ninh|t ninh
hà quảng	cao bằng|c bằng|cbằng
nam đàn|n đàn	nghệ an
hướng hóa|h hóa	quảng trị|q trị
ea h'leo	đắk lắk|đ lắk|đlắk|đăk lăk|đ lăk|đlăk
tân thạnh|t thạnh	long an|l an
đại từ|đ từ	thái nguyên|t nguyên
quang bình|q bình	hà giang|h giang
thường tín|t tín|tt	hà nội|hn|h nội|hnội
nghĩa hưng|n hưng	nam định|n định
phú quý|p quý	bình thuận|b thuận
nậm nhùn|n nhùn	lai châu|l châu|lchâu
đầm hà|đ hà	quảng ninh|q ninh
hàm yên|h yên	tuyên quang|t quang
sơn trà|s trà|st	đà nẵng|đn|t phố đà nẵng| tp đà nẵng
an biên	kiên giang|k giang
từ sơn	bắc ninh|b ninh|bninh
mù cang chải|m c chải	yên bái|y bái|ybái
văn lâm|v lâm	hưng yên|h yên
kim bôi|k bôi	hòa bình|h bình|hbình
sơn tây|s tây	quảng ngãi|q ngãi
văn bàn|v bàn	lào cai|l cai
quỳ châu|q châu	nghệ an
kiên lương|k lương	kiên giang|k giang
phan thiết|p thiết	bình thuận|b thuận
như thanh|n thanh	thanh hóa|t hóa|thóa
gia lâm|g lâm|gl	hà nội|hn|h nội|hnội
bắc hà|b hà	lào cai|l cai
lạc thủy|l thủy	hòa bình|h bình|hbình
đạ tẻh	lâm đồng|l đồng
hưng yên|h yên	hưng yên|h yên
vĩnh thuận|v thuận	kiên giang|k giang
càng long|c long	trà vinh|t vinh|tvinh
thọ xuân|t xuân	thanh hóa|t hóa|thóa
văn quan|v quan	lạng sơn|l sơn
an dương|ad	hải phòng|hp
dư hàng|d hàng	hải phòng|hp
lộc hà|l hà	hà tĩnh|h tĩnh
ân thi	hưng yên|h yên
gò công đông|g c đông	tiền giang|t giang
tiên yên|t yên	quảng ninh|q ninh
thái nguyên|t nguyên	thái nguyên|t nguyên
đức phổ|đ phổ	quảng ngãi|q ngãi
vị xuyên	hà giang|h giang
hạ hòa	phú thọ|p thọ
vĩnh lợi|v lợi	bạc liêu|b liêu
krông năng|k năng	đắk lắk|đ lắk|đlắk|đăk lăk|đ lăk|đlăk
châu thành|c thành	kiên giang|k giang
quảng ninh|q ninh	quảng bình|q bình|qbình
hoài ân|h ân	bình định|b định
chương mỹ|c mỹ|cm	hà nội|hn|h nội|hnội
nho quan|n quan	ninh bình|n bình
thanh liêm|t liêm	hà nam|h nam
hương trà|h trà	thừa thiên huế|tt huế|tth
tri tôn|t tôn	an giang
quận 4|4|q4	 hồ chí minh|hcm|hồchíminh|tp hồ chí minh|tp hồchíminh|tp hồ cm|hồ cm
hồng dân|h dân	bạc liêu|b liêu
đức huệ|đ huệ	long an|l an
vĩnh tường|v tường	vĩnh phúc|v phúc
đồ sơn|đs	hải phòng|hp
tây ninh|t ninh	tây ninh|t ninh
phong thổ|p thổ	lai châu|l châu|lchâu
buôn ma thuột|bmt|b m t|b m thuột	đắk lắk|đ lắk|đlắk|đăk lăk|đ lăk|đlăk
tân uyên|t uyên	bình dương|b dương
chợ mới|c mới	an giang
sơn dương|s dương	tuyên quang|t quang
mường la|m la	sơn la
buôn đôn|b đôn	đắk lắk|đ lắk|đlắk|đăk lăk|đ lăk|đlăk
long thành|l thành	đồng nai|đ nai|đnai
ngọc hiển|n hiển	cà mau|c mau
cẩm phả|c phả	quảng ninh|q ninh
vạn ninh|v ninh	khánh hòa|k hòa
đồng hới|đ hới	quảng bình|q bình|qbình
ngã năm|n năm	sóc trăng|s trăng
phù cát|p cát	bình định|b định
điện bàn|đ bàn	quảng nam|q nam
phú vang|p vang	thừa thiên huế|tt huế|tth
bình tân|b tân	vĩnh long|v long|vĩnhlong
hoằng hóa|h hóa	thanh hóa|t hóa|thóa
sơn tây|s tây|st	hà nội|hn|h nội|hnội
bảo lạc|b lạc	cao bằng|c bằng|cbằng
hà tĩnh	hà tĩnh|h tĩnh
hậu lộc|h lộc	thanh hóa|t hóa|thóa
ngã bảy|n bảy	hậu giang|h giang
vĩnh thạnh|v thạnh	cần thơ|c thơ|cthơ
lạng giang|l giang	bắc giang|b giang
quận 12|12|q12	 hồ chí minh|hcm|hồchíminh|tp hồ chí minh|tp hồchíminh|tp hồ cm|hồ cm
khoái châu|k châu	hưng yên|h yên
đan phượng|đ phượng|đp	hà nội|hn|h nội|hnội
phú tân|p tân	cà mau|c mau
quế sơn|q sơn	quảng nam|q nam
giá rai|g rai	bạc liêu|b liêu
giồng riềng|g riềng	kiên giang|k giang
lấp vò|l vò	đồng tháp|đ tháp
gia bình|g bình	bắc ninh|b ninh|bninh
quảng trị|q trị	quảng trị|q trị
chí linh|c linh	hải dương|h dương
chợ gạo|c gạo	tiền giang|t giang
nhơn trạch|n trạch	đồng nai|đ nai|đnai
giồng trôm|g trôm	bến tre|b tre
bàu bàng|b bàng	bình dương|b dương
hồng lĩnh|h lĩnh	hà tĩnh|h tĩnh
kiến thụy|k thụy|kt	hải phòng|hp
na rì	bắc kạn|b kạn
an khê	gia lai|g lai
hội an|h an	quảng nam|q nam
trà vinh|t vinh|tvinh	trà vinh|t vinh|tvinh
vĩnh linh|v linh	quảng trị|q trị
châu phú|c phú	an giang
hương sơn|h sơn	hà tĩnh|h tĩnh
tràng định|t định	lạng sơn|l sơn
tương dương|t dương	nghệ an
phú tân|p tân	an giang
cẩm lệ|c lệ|cl	đà nẵng|đn|t phố đà nẵng| tp đà nẵng
đông triều|đ triều	quảng ninh|q ninh
ba đồn	quảng bình|q bình|qbình
sa đéc	đồng tháp|đ tháp
trấn yên|t yên	yên bái|y bái|ybái
vĩnh yên|v yên	vĩnh phúc|v phúc
tiền hải|t hải	thái bình|t bình
vĩnh bảo|v bảo|vb	hải phòng|hp
cửa lò|c lò	nghệ an
bắc bình|b bình	bình thuận|b thuận
bác ái|b ái	ninh thuận|n thuận
bắc giang|b giang	bắc giang|b giang
yên châu|y châu	sơn la
tân châu|t châu	an giang
hoàng mai|h mai	nghệ an
đăk đoa|đ đoa	gia lai|g lai
tây trà|t trà	quảng ngãi|q ngãi
yên thủy|y thủy	hòa bình|h bình|hbình
quỳ hợp|q hợp	nghệ an
mang yang|m yang	gia lai|g lai
thanh thủy|t thủy	phú thọ|p thọ
hóc môn|h môn|hm	 hồ chí minh|hcm|hồchíminh|tp hồ chí minh|tp hồchíminh|tp hồ cm|hồ cm
minh hóa|m hóa	quảng bình|q bình|qbình
bảo lộc|b lộc	lâm đồng|l đồng
khánh sơn|k sơn	khánh hòa|k hòa
ngũ hành sơn|n h sơn|nhs	đà nẵng|đn|t phố đà nẵng| tp đà nẵng
nghĩa lộ|n lộ	yên bái|y bái|ybái
cô tô	quảng ninh|q ninh
bình long|b long	bình phước|b phước
lạng sơn|l sơn	lạng sơn|l sơn
long xuyên|l xuyên	an giang
liên chiểu|l chiểu|lc	đà nẵng|đn|t phố đà nẵng| tp đà nẵng
thuận an|t an	bình dương|b dương
sóc trăng|s trăng	sóc trăng|s trăng
trần đề|t đề	sóc trăng|s trăng
kim thành|k thành	hải dương|h dương
châu thành|c thành	tây ninh|t ninh
lý nhân	hà nam|h nam
kim động|k động	hưng yên|h yên
ea súp	đắk lắk|đ lắk|đlắk|đăk lăk|đ lăk|đlăk
tân yên|t yên	bắc giang|b giang
cẩm xuyên|c xuyên	hà tĩnh|h tĩnh
thốt nốt|t nốt	cần thơ|c thơ|cthơ
yên dũng|y dũng	bắc giang|b giang
thuận nam|t nam	ninh thuận|n thuận
nghĩa hành|n hành	quảng ngãi|q ngãi
bến cát|b cát	bình dương|b dương
văn lãng|v lãng	lạng sơn|l sơn
bình lục|b lục	hà nam|h nam
sơn tịnh|s tịnh	quảng ngãi|q ngãi
tiểu cần|t cần	trà vinh|t vinh|tvinh
quan hóa|q hóa	thanh hóa|t hóa|thóa
kiên hải|k hải	kiên giang|k giang
quản bạ|q bạ	hà giang|h giang
an lão	bình định|b định
mỏ cày bắc|m c bắc	bến tre|b tre
diễn châu|d châu	nghệ an
ia h' drai	kon tum|k tum|ktum
yên khánh|y khánh	ninh bình|n bình
tân phú đông|t p đông	tiền giang|t giang
lắk	đắk lắk|đ lắk|đlắk|đăk lăk|đ lăk|đlăk
dầu tiếng|d tiếng	bình dương|b dương
thủ đức|t đức|tđ	 hồ chí minh|hcm|hồchíminh|tp hồ chí minh|tp hồchíminh|tp hồ cm|hồ cm
vinh	nghệ an
củ chi|cc	 hồ chí minh|hcm|hồchíminh|tp hồ chí minh|tp hồchíminh|tp hồ cm|hồ cm
chơn thành|c thành	bình phước|b phước
gio linh|g linh	quảng trị|q trị
ngọc hồi|n hồi	kon tum|k tum|ktum
quan sơn|q sơn	thanh hóa|t hóa|thóa
vĩnh châu|v châu	sóc trăng|s trăng
châu thành|c thành	sóc trăng|s trăng
đức cơ|đ cơ	gia lai|g lai
cam ranh|c ranh	khánh hòa|k hòa
hồng bàng|h bàng|hb	hải phòng|hp
tuần giáo|t giáo	điện biên|đ biên
tam nông|t nông	đồng tháp|đ tháp
quảng uyên|q uyên	cao bằng|c bằng|cbằng
tam kỳ|t kỳ	quảng nam|q nam
núi thành|n thành	quảng nam|q nam
xuân lộc|x lộc	đồng nai|đ nai|đnai
ngô quyền|n quyền|nq	hải phòng|hp
huế	thừa thiên huế|tt huế|tth
bạch thông|b thông	bắc kạn|b kạn
cẩm giàng|c giàng	hải dương|h dương
ea kar	đắk lắk|đ lắk|đlắk|đăk lăk|đ lăk|đlăk
thạnh trị|t trị	sóc trăng|s trăng
quận 6|6|q6	 hồ chí minh|hcm|hồchíminh|tp hồ chí minh|tp hồchíminh|tp hồ cm|hồ cm
sầm sơn|s sơn	thanh hóa|t hóa|thóa
nam định|n định	nam định|n định
krông búk|k búk	đắk lắk|đ lắk|đlắk|đăk lăk|đ lăk|đlăk
nông sơn|n sơn	quảng nam|q nam
hoài đức|h đức|hđ	hà nội|hn|h nội|hnội
lục nam|l nam	bắc giang|b giang
nghi xuân|n xuân	hà tĩnh|h tĩnh
sóc sơn|s sơn|ss	hà nội|hn|h nội|hnội
an minh	kiên giang|k giang
duyên hải|d hải	trà vinh|t vinh|tvinh
kon rẫy|k rẫy	kon tum|k tum|ktum
đầm dơi|đ dơi	cà mau|c mau
cát tiên|c tiên	lâm đồng|l đồng
gò vấp|gv	 hồ chí minh|hcm|hồchíminh|tp hồ chí minh|tp hồchíminh|tp hồ cm|hồ cm
tân hiệp|t hiệp	kiên giang|k giang
tân lạc|t lạc	hòa bình|h bình|hbình
đoan hùng|đ hùng	phú thọ|p thọ
bình liêu|b liêu	quảng ninh|q ninh
phú lộc|p lộc	thừa thiên huế|tt huế|tth
ba vì|bv	hà nội|hn|h nội|hnội
lý sơn	quảng ngãi|q ngãi
bắc yên|b yên	sơn la
quận 7|7|q7	 hồ chí minh|hcm|hồchíminh|tp hồ chí minh|tp hồchíminh|tp hồ cm|hồ cm
văn giang|v giang	hưng yên|h yên
phúc yên|p yên	vĩnh phúc|v phúc
yên định|y định	thanh hóa|t hóa|thóa
văn chấn|v chấn	yên bái|y bái|ybái
triệu sơn|t sơn	thanh hóa|t hóa|thóa
trà bồng|t bồng	quảng ngãi|q ngãi
cờ đỏ	cần thơ|c thơ|cthơ
bến cầu|b cầu	tây ninh|t ninh
vũ quang	hà tĩnh|h tĩnh
bến tre|b tre	bến tre|b tre
thông nông|t nông	cao bằng|c bằng|cbằng
cẩm khê|c khê	phú thọ|p thọ
cam lộ|c lộ	quảng trị|q trị
tây giang|t giang	quảng nam|q nam
yên minh|y minh	hà giang|h giang
hiệp hòa|h hòa	bắc giang|b giang
hương thủy|h thủy	thừa thiên huế|tt huế|tth
tam bình|t bình	vĩnh long|v long|vĩnhlong
kon tum|k tum|ktum	kon tum|k tum|ktum
bắc trà my|b t my	quảng nam|q nam
vĩnh lộc|v lộc	thanh hóa|t hóa|thóa
kỳ anh	hà tĩnh|h tĩnh
tuy đức|t đức	đắk nông|đ nông
vân hồ|v hồ	sơn la
kim sơn|k sơn	ninh bình|n bình
an nhơn	bình định|b định
phú giáo|p giáo	bình dương|b dương
hàm thuận nam|h t nam	bình thuận|b thuận
tân hưng|t hưng	long an|l an
ba tri	bến tre|b tre
phù yên|p yên	sơn la
lạc dương|l dương	lâm đồng|l đồng
thanh trì|t trì|tt	hà nội|hn|h nội|hnội
trường sa|t sa	khánh hòa|k hòa
biên hòa|b hòa	đồng nai|đ nai|đnai
tam dương|t dương	vĩnh phúc|v phúc
cầu giấy|c giấy|cg	hà nội|hn|h nội|hnội
điện biên đông|đ b đông	điện biên|đ biên
đất đỏ|đ đỏ	 bà rịa vũng tàu|bà rịa|vũng tàu|b rịa v tàu|bà rịa vtàu|brịa vtàu
lào cai|l cai	lào cai|l cai
cà mau	cà mau|c mau
kinh môn|k môn	hải dương|h dương
từ liêm|bắc từ liêm|tl|btl	hà nội|hn|h nội|hnội
lệ thủy	quảng bình|q bình|qbình
mường lát|m lát	thanh hóa|t hóa|thóa
quế phong|q phong	nghệ an
mỹ đức|mđ	hà nội|hn|h nội|hnội
lương sơn|l sơn	hòa bình|h bình|hbình
đam rông|đ rông	lâm đồng|l đồng
phong điền|p điền	thừa thiên huế|tt huế|tth
quảng trạch|q trạch	quảng bình|q bình|qbình
yên thế|y thế	bắc giang|b giang
phù ninh|p ninh	phú thọ|p thọ
cao bằng|c bằng|cbằng	cao bằng|c bằng|cbằng
hà đông	hà tây|h tây
sơn tây|s tây	hà tây|h tây
ba vì	hà tây|h tây
phúc thọ|p thọ	hà tây|h tây
thạch thất|t thất	hà tây|h tây
quốc oai|q oai	hà tây|h tây
chương mỹ|c mỹ	hà tây|h tây
đan phượng|đ phượng	hà tây|h tây
hoài đức|h đức	hà tây|h tây
thanh oai|t oai	hà tây|h tây
mỹ đức	hà tây|h tây
ứng hoà|ứ hoà	hà tây|h tây
thường tín|t tín	hà tây|h tây
phú xuyên|p xuyên	hà tây|h tây
